9.ox
....o...o....
.............
....oo.o.....
....oo..ooo..
oo.oo.......o
.............
....oo.o.....
....oo..ooo..
oo.oo.......o

EOF

