4242P
224242424242424242422242424244424242424242
244424242424242424242424242444222424242424
424244424222424242424242424242424242224442
242424242424222424242424242444242424242424
424242424242424242444442424242424242424242
242424242424242424242424244422242424242424
424242224242424242424244424242424242444242
242424244424244424242424242424242424222424
424242424242424242424222224242424242424242
242424242224242424242424242424442424244424
424242244242424242424242424242424244422242
242424242424222224242424242424242424242424
424222424242424242424244424242424442424242
442424242424242424242444242424222424242424
444242422242424242424242424242224242424442
242224242424242444242424242424244424242424
424242424242424242424242244242424242424242
222424242424242424242224242424244424242424
424242424442424442424242424242424242424222
242422242424242422242424242424242444242424
424242424242422242424242444242424242424242
244424242424442424242424242424242224242422
424242424222424242424242424242424242424244
242424242424242424444424242424242424242424
424242424242424242224242422222222242424242
242224242424242424242424242444442444242424
424242424244424244424242422444442242424242
242424242422242424222424242444442424242444
424242444242424242424242422444442242224242
442444242424242424242424242444442422242424
422242424242224242424242422222222242424242
242424242444242424244424242424242424242224
424242424242424242424242424222424242424242
242422242424242424222424242424242424442424
424242424242444242424242422242424242424242
242424242424242424242222242424242424242424
424242422242424242424242424244424242444242
242424442424242424242424442424242424222424
424242424442422242424242424242424242422242
242424442424242424242444242424242422242424
424242424242444242424242424242224242424242
242444222424242424242424242424242224244424
