42HF 
FFHFHFHFHFFHFFFFFFFFFFFFHHHHHHHHHHHHFHHFHH
FHHFFFFHFHHFHFFFFFFFFFFFFFHHHHHHHHHHHHFHHH
FFHFHHHHHHHHHFFFFFFFFFFFHFHFHHHHHHHHHFHHHF
FFFHHHHHHHHFFFFFHFFFHFFFFFHHFFHHHHHHHHHFFF
FFHHHHHHHHHFFFFFFFFFFHHHFFHHHFHHHHHHHHFFFF
HHHHHHHHHHFFFFHFFFFHHFFHFFHHHHHHFHHHHHFFFF
HHHHHHHHHHHFHFFFFFFFFFFHHHFHHHFHHHHHFHFHHF
HHHHHHHHHFHFHFFFFFFFFFFFFFFHHFHHFFFFFHFHFF
HHHHHHHHHFFFHFFFFFFFFFFFFFFFFFFFFFHFFHFHFH
HHHHHHHFHHHFHFHHHHHHHHHHHHHHHHHHHFFFFFFFFF
HHHHFFHFHHHHHFHHHHHHHHHHHHHHHHHHHFFFFFFFFF
FHHHFHHHHHHHHFHHHHHHHHHHHHHHHHHHHFFFFFFFHF
FHHFFHHHHHHHHFHHHHHHHHHHHHHHHHHHHFFFFFFFFF
FFFHHFHHHHHHFFHHHHHHHHHHHHHHHHHHHFFFFFFFFH
FFFFFHHHHHHHHFHHHHHHHHHHHHHHHHHHHFFFFFFFFH
FFFFFFHHHHHFHFHHHHHHHHHHHHHHHHHHHFFFFFFFFF
FFHHHFFHFHHFFFHHHHHHHHHHHHHHHHHHHFHHFFFFFF
FFFHHHHFFFFFFFHHHHHHHHHHHHHHHHHHHFFHFHFHFF
FFFHHHHHFFFFFFHHHHHHHHHHHHHHHHHHHFFHHHFFFF
HHFHHHFHFFFFFFHHHHHHHHHHHHHHHHHHHFHFHHHHFF
FHHHHHHFFFFFFFHHHHHHHHHHHHHHHHHHHFFFHHHHFF
HHHHHHHFFFFFFFHHHHHHHHHHHHHHHHHHHFHFHHHHFF
HHHHHHFFFFFFFFHHHHHHHHHHHHHHHHHHHFHFHHHHHH
HHHHHHHFFFFFFFHHHHHHHHHHHHHHHHHHHFFFHHHHHH
HHHHHFHFFFFFFFHHHHHHHHHHHHHHHHHHHFFHHHHHHH
HHHHFHHFFFFFFFHHHHHHHHHHHHHHHHHHHFFHFHHFHH
HHHHHHHFFFFFFFHHHHHHHHHHHHHHHHHHHFFFFFHHHH
HHHHHFHFFFFFFFHHHHHHHHHHHHHHHHHHHFFHHFHHHH
HHHHHHFFFFHFFFFFFFFFFFFFFFFFFFFFFFFFFFHHHH
HHHHHHHHFHFFFHHFHFHFHFFFFFHFFFFFFFFFFHFFHH
HHHHHHHHHHHFHHHFFFFHHFHFHFFFHHFFFFFFHHHHHH
FHFHHHHFFHHHHHFHHHHHHHFHHFHFFFFFFFFFHHHHHH
HFFHHHHHFHHHHFHFFFFHHHHHHFFHFFFFFFFFFHHHFF
FFHHFFFHHHHHHFHHHHHHHHHHHHHHFFFFFFFFHHHFFF
FFFFFHHFFHFFFHHHHHHHHHHHHHHHFFFFFFHHFHHHFH
FFFFFFHHHFFHHFHHHHHHHHHHHHFFFFFFFHHHHHHHHH
FFFFFFFFHFFFHHHHHHHHHHHHHFFFFFFFFHHHHHHHFF
FFFFFFFFHHFHHHHHHHHHHHHHHFFFFFFFHHHHHFHHFF
FFFFFFFFFFFHHHHHHHHHHHHHHFFFFFFHHHHHHHHHFH
FFFFFFFFFFFFFHHHHHHHHHHFFFFFHFHHHHHHHHFHFH
FHFFFFFFFFFHHHHHHHHHHHFFFFFFFHFHHHHHHHHHHH
FFFFFFFFFFFHFHHFHHFFFFFFFFFHFHHHHHHHHHHHHH
